00000000000000000000000000000000000000000000000000000000
00000000000000000300000000000000000000000000000000000000
00000000000000000000000000000000000000000000000000000000
00000111111111111111111111111111100000000000000000000000
00000000000000000000000000000000000000000000000000000000
00000000000000000000000000000000000000000000000000000000
00000000000000000000000000000000030000000000000000000000
00000000000000001000000000000011111111100000000000000000
00000000000000001000000000000000000000000000000000000000
00000000000000301000000000000000000000000000000000000000
00000000000000001000000000000000000000000000000000000000
00000000000000001000000000000000000000000000000000000000
00000000000000001000000000000000000000000000000000000000
00000000000000000000000000000000000300000000000000000000
00000000000000000000000000000000000000000000000000000000
00000111111111111111111111111111111111111111111110000000
00000000000000000000000000000000000000000000000000000000
00000000000000000000000000200000000000000000000000000000
00000000000000000000000000000000000000000000000000000000
00000000000000000000000000000000000000000000000000000000