00000000000000000000000000000000000000000000010000000000
00000000003000000000000000000000000000000000010000200000
00000000000000000000000000000000000000000000010000000000
00000111111111111111111111111111100000000000010111111111
00000000000000000000000000000000100000000000000000000000
00000000000000000000000000000000100000000000000000000000
03000000000000000000000030000000100000000000003000000003
00000000000000000000000000000000100000000000000000000000
11111111111111111100000000000000100000000000000000000000
00000000000000000000000000000000100000000000000000000000
00000000000000000000000000111111111111111111111110000000
00000000000000000000000000000000000001000000000000000000
00000000000000000000000000000000000001000300000000000000
11111111111111111111100000111111111111111111111111111111
00000000000000000000000000000000000000000000000000000000
00000000000000000000000000000000000000000000000300000000
00030000000000000000000000000000000000000000000000000000
00000000000000000000000000000000000000000000000000000000
00000000000000000000000000000000000000000000000300000000
00000000000000000000000000000000000000000000000000000000