00000000000000000000000000000000000000000000000000000000
00000003000000000000000003000000000000000300000000000000
00000111111111111111111111111111111111111111111111100000
00000100000000000000000000000000000000000000000000100000
00000100000000000000000000000000000000000000000000100000
00000100000000000000000000000000000000000000000000100000
00000100000030000000000000000000000000000000000000100000
00000100000000000000000000000000000000000000000000100000
00000100000000000000000000000000000000000000000000100300
00000111111111111111100000000000000000000000000000100000
00000100000000000000000000000000300000000000000000100000
00000100000000000000000000000000000000000000000000100000
00000100000000000000000000000000000000000000000000100000
00000100000000000000000000111111111111111111111111100000
00000100000000000000000000000000000000000000000000000000
00000100000000000000000000000000000000000000000000000000
00000100000000000000000000000000000000000000000000000000
00000100000000000000000000000000000000000030000000000000
00200100000000000000000000000000000000000000000000000000
00000100000000000000000000000000000000000000000000000000