00000000000000000000000000000000000000000000000000000000
00000000000000000000000000000000000000000000000000000000
00000000000000000000000000000000000000000000000000000000
00000111111111111111111111111111100000000000030000000000
00000000000000000000000000000000000000000000000000000000
00000000000000000000000000000000000000000000000000000000
00000000000000000000000000000000000000000000000000000000
00000000000000000000000000000000000000000000000000000000
00000000000000000000000000000000000000000000000000000000
00000000000000333300000000000000000000000000000000000000
00000000000000000000000000111111111111000000000000000000
00000000000000000000000000000000000001000000000000000000
00000000000000000000000000000000000001000000000000000000
00000000000000000000000000111111111111111111111111111100
00000000000010000011110010000000000000000000000000000000
00000000000010000010010010000000000002000000000000000000
00000000000010000010010010000000000000000000000000000000
00000000000011110011110011110000000000000000000000000000
00000000000000000000000000000000000000000000000000000000
00000000000000000000000000000000000000000000000000000000