00000000000000000000000000000000000000000000000000000000
00000000000000000000000000000000000000000000000000000000
00000000000000000000000000000000000000000000000000000000
00000111111111111111111111111111100000000000030000000000
00000000000000000000000000000000000000000000000000000000
00000000000000000000000000000000000000000000000000000000
00000000000000000000000000000000000000000000000000000000
00000000000000000000000000000000000000000000000000000000
00000000000000000000000000000000000000000000000000000000
00000000000000300000000000000000000000000000000000000000
00000000000000000000000000111111111111000000000000000000
00000000000000000000000000000000000001000000000000000000
00000000000000000000000000000000000001000000000000000000
00000000000000000000000011111111111111111111111111111100
00000000000000000000000100000000000000000000000000000000
00000000000000000000001000000000000002000000000000000000
00000000000000000000010000000000000000000000000000000000
00000000000000000000100000000000000000000000000000000000
00000000000000000000000000000000000000000000000000000000
00000000000000000000000000000000000000000000000000000000