00000000000000000000000000000000000000000000000000000000
00000000000000000300000000000000000000000000000000000000
00000000000000000000000000000000000000000000000000000000
00000111111111111111111111111111100000000000000000000000
00000000000000000000000000000000000000000000000000000000
00000000000000000000000000000000000000000000000000000000
00000000000000000000000000000000000000000000000000000000
00000000000003000000000000000000000000000000000000000000
00000000000000000000000000000000000000000000000000000000
00000000111111111111111111111111111111111111111111111111
00000000100000000000000000000003001000000003000000000000
00000000100000000000000000000000001000000000000000000000
00000000100000000000000000000000000000000000000000000000
00000000000000000000000000111111111111111111111111111111
00000000000000000000000000000000003000000000000000000000
11111111111111111111111111111111111111111110000000000000
00000000000000000000000000000000000000000000000000000000
00000000000020000010000000000000000000000000000000000000
00000000000000000010000000000030000000000000000000000000
00000000000000000010000000000000000000000000000000000000